year,course,enrolment_F,enrolment_MF,graduates_F,graduates_MF,intake_F,intake_MF,intake_rate_F,intake_rate_MF,intake_men,enrolment_men,graduates_men,intake_rate_men
2005,Accountancy,1732,2561,495,706,530.0,876.0,30.600461893764436,34.20538852010933,346.0,829,211,41.73703256936068
2005,"Architecture, Building & Real Estate",786,1310,106,180,175.0,299.0,22.264631043256998,22.82442748091603,124.0,524,74,23.66412213740458
2005,Business & Administration,3098,5013,898,1256,901.0,1545.0,29.08327953518399,30.819868342309995,644.0,1915,358,33.62924281984334
2005,Dentistry,67,139,12,34,19.0,33.0,28.35820895522388,23.741007194244606,14.0,72,22,19.444444444444443
2005,Education,0,0,0,0,0.0,0.0,,,0.0,0,0,
2005,Engineering Sciences,4868,16599,1200,3859,1170.0,4028.0,24.034511092851275,24.26652207964335,2858.0,11731,2659,24.36279942033927
2005,Fine & Applied Arts,212,355,11,22,103.0,163.0,48.58490566037736,45.91549295774648,60.0,143,11,41.95804195804196
2005,Health Sciences,352,433,69,85,149.0,176.0,42.32954545454545,40.646651270207855,27.0,81,16,33.333333333333336
2005,Humanities & Social Sciences,4799,6743,1249,1650,1644.0,2233.0,34.25713690352157,33.115823817292004,589.0,1944,401,30.29835390946502
2005,Information Technology,765,2356,200,562,280.0,773.0,36.60130718954248,32.80984719864177,493.0,1591,362,30.986800754242616
2005,Law,498,844,125,187,125.0,220.0,25.100401606425702,26.066350710900473,95.0,346,62,27.45664739884393
2005,Mass Communication,507,644,110,146,130.0,172.0,25.641025641025642,26.70807453416149,42.0,137,36,30.656934306569344
2005,Medicine,479,1169,86,209,103.0,233.0,21.50313152400835,19.931565440547477,130.0,690,123,18.840579710144926
2005,"Natural, Physical & Mathematical Sciences",3416,5389,769,1135,1004.0,1701.0,29.39110070257611,31.564297643347558,697.0,1973,366,35.32691332995439
2005,Services,80,108,0,0,38.0,56.0,47.5,51.851851851851855,18.0,28,0,64.28571428571429
2006,Accountancy,1819,2844,468,644,557.0,934.0,30.621220450797143,32.84106891701828,377.0,1025,176,36.78048780487805
2006,"Architecture, Building & Real Estate",810,1336,193,329,226.0,379.0,27.901234567901234,28.368263473053894,153.0,526,136,29.08745247148289
2006,Business & Administration,3297,5490,818,1250,1035.0,1772.0,31.392174704276616,32.27686703096539,737.0,2193,432,33.60693114455084
2006,Dentistry,78,148,14,32,26.0,42.0,33.333333333333336,28.37837837837838,16.0,70,18,22.857142857142858
2006,Education,0,0,0,0,0.0,0.0,,,0.0,0,0,
2006,Engineering Sciences,4694,16663,1137,3811,1025.0,4101.0,21.836386876864083,24.61141451119246,3076.0,11969,2674,25.699724287743337
2006,Fine & Applied Arts,334,557,13,24,137.0,233.0,41.01796407185629,41.83123877917415,96.0,223,11,43.04932735426009
2006,Health Sciences,489,583,57,81,201.0,240.0,41.104294478527606,41.1663807890223,39.0,94,24,41.48936170212766
2006,Humanities & Social Sciences,5282,7532,1298,1758,1813.0,2573.0,34.3241196516471,34.160913436006375,760.0,2250,460,33.77777777777778
2006,Information Technology,796,2505,139,540,185.0,728.0,23.241206030150753,29.06187624750499,543.0,1709,401,31.772966647162082
2006,Law,463,872,134,204,102.0,238.0,22.03023758099352,27.293577981651374,136.0,409,70,33.251833740831295
2006,Mass Communication,555,685,108,141,153.0,180.0,27.56756756756757,26.277372262773724,27.0,130,33,20.76923076923077
2006,Medicine,503,1188,94,229,119.0,251.0,23.658051689860834,21.127946127946128,132.0,685,135,19.27007299270073
2006,"Natural, Physical & Mathematical Sciences",3755,5899,955,1384,1348.0,1994.0,35.89880159786951,33.80233937955586,646.0,2144,429,30.130597014925375
2006,Services,117,177,0,0,36.0,68.0,30.76923076923077,38.4180790960452,32.0,60,0,53.333333333333336
2007,Accountancy,1914,3074,574,834,625.0,1000.0,32.65412748171369,32.53090435914118,375.0,1160,260,32.327586206896555
2007,"Architecture, Building & Real Estate",934,1479,177,288,313.0,453.0,33.5117773019272,30.628803245436107,140.0,545,111,25.68807339449541
2007,Business & Administration,3363,5675,893,1384,1069.0,1733.0,31.787094855783526,30.537444933920703,664.0,2312,491,28.719723183391004
2007,Dentistry,89,154,15,36,26.0,42.0,29.213483146067414,27.272727272727273,16.0,65,21,24.615384615384617
2007,Education,0,0,0,0,0.0,0.0,,,0.0,0,0,
2007,Engineering Sciences,4553,16042,1258,4366,1192.0,4064.0,26.18054030309686,25.333499563645432,2872.0,11489,3108,24.997824005570546
2007,Fine & Applied Arts,429,711,41,69,147.0,242.0,34.26573426573427,34.036568213783404,95.0,282,28,33.687943262411345
2007,Health Sciences,617,745,67,86,207.0,259.0,33.54943273905997,34.76510067114094,52.0,128,19,40.625
2007,Humanities & Social Sciences,6176,8667,1123,1607,2056.0,2812.0,33.29015544041451,32.444905965155186,756.0,2491,484,30.34925732637495
2007,Information Technology,824,2660,206,573,249.0,776.0,30.218446601941746,29.172932330827066,527.0,1836,367,28.703703703703702
2007,Law,547,1004,123,207,208.0,332.0,38.02559414990859,33.06772908366534,124.0,457,84,27.133479212253828
2007,Mass Communication,546,693,141,169,136.0,182.0,24.90842490842491,26.262626262626263,46.0,147,28,31.292517006802722
2007,Medicine,536,1207,83,227,116.0,250.0,21.64179104477612,20.712510356255176,134.0,671,144,19.970193740685545
2007,"Natural, Physical & Mathematical Sciences",4232,6605,869,1325,1415.0,2137.0,33.43572778827977,32.35427706283119,722.0,2373,456,30.425621576064053
2007,Services,163,246,0,0,48.0,71.0,29.447852760736197,28.86178861788618,23.0,83,0,27.710843373493976
2008,Accountancy,1910,3139,536,831,638.0,1055.0,33.403141361256544,33.60942975469895,417.0,1229,295,33.9300244100895
2008,"Architecture, Building & Real Estate",952,1530,232,368,272.0,452.0,28.571428571428573,29.54248366013072,180.0,578,136,31.141868512110726
2008,Business & Administration,3423,5848,959,1462,943.0,1536.0,27.54893368390301,26.265389876880985,593.0,2425,503,24.45360824742268
2008,Dentistry,93,163,17,35,21.0,44.0,22.580645161290324,26.993865030674847,23.0,70,18,32.857142857142854
2008,Education,0,0,0,0,0.0,0.0,,,0.0,0,0,
2008,Engineering Sciences,4102,14368,1254,3887,1064.0,3598.0,25.938566552901023,25.04175946547884,2534.0,10266,2633,24.683421001363726
2008,Fine & Applied Arts,503,845,50,81,129.0,236.0,25.646123260437374,27.928994082840237,107.0,342,31,31.28654970760234
2008,Health Sciences,712,888,77,87,185.0,247.0,25.98314606741573,27.815315315315317,62.0,176,10,35.22727272727273
2008,Humanities & Social Sciences,6783,9609,1312,1817,1971.0,2823.0,29.05793896505971,29.378707461754605,852.0,2826,505,30.148619957537154
2008,Information Technology,1021,3781,275,900,307.0,1033.0,30.068560235063664,27.32081459931235,726.0,2760,625,26.304347826086957
2008,Law,649,1143,115,209,221.0,356.0,34.05238828967642,31.146106736657917,135.0,494,94,27.327935222672064
2008,Mass Communication,543,688,132,164,133.0,169.0,24.49355432780847,24.563953488372093,36.0,145,32,24.82758620689655
2008,Medicine,566,1236,96,227,127.0,260.0,22.43816254416961,21.035598705501616,133.0,670,131,19.850746268656717
2008,"Natural, Physical & Mathematical Sciences",4651,7413,856,1347,1333.0,2261.0,28.660503117609117,30.500472143531635,928.0,2762,491,33.598841419261404
2008,Services,157,253,43,57,36.0,65.0,22.929936305732483,25.691699604743082,29.0,96,14,30.208333333333332
2009,Accountancy,2059,3471,595,937,663.0,1142.0,32.200097134531326,32.90118121578796,479.0,1412,342,33.92351274787536
2009,"Architecture, Building & Real Estate",1027,1659,163,283,254.0,434.0,24.732229795520936,26.160337552742615,180.0,632,120,28.481012658227847
2009,Business & Administration,3270,5709,855,1482,824.0,1519.0,25.198776758409785,26.607111578209842,695.0,2439,627,28.495284952849527
2009,Dentistry,103,180,19,31,29.0,48.0,28.155339805825243,26.666666666666668,19.0,77,12,24.675324675324674
2009,Education,0,0,0,0,0.0,0.0,,,0.0,0,0,
2009,Engineering Sciences,4218,14522,1117,3870,1278.0,4199.0,30.298719772403985,28.91475003443052,2921.0,10304,2753,28.348214285714285
2009,Fine & Applied Arts,548,957,88,135,148.0,269.0,27.00729927007299,28.108672936259143,121.0,409,47,29.584352078239608
2009,Health Sciences,800,1042,107,129,204.0,295.0,25.5,28.310940499040306,91.0,242,22,37.603305785123965
2009,Humanities & Social Sciences,7272,10434,1606,2179,2138.0,3082.0,29.4004400440044,29.538048686984858,944.0,3162,573,29.85452245414295
2009,Information Technology,1132,3975,175,616,320.0,991.0,28.268551236749115,24.930817610062892,671.0,2843,441,23.60182905381639
2009,Law,711,1321,118,207,186.0,383.0,26.160337552742615,28.99318697956094,197.0,610,89,32.295081967213115
2009,Mass Communication,516,692,128,164,102.0,168.0,19.767441860465116,24.277456647398843,66.0,176,36,37.5
2009,Medicine,596,1278,97,219,126.0,260.0,21.140939597315437,20.344287949921753,134.0,682,122,19.64809384164223
2009,"Natural, Physical & Mathematical Sciences",4932,8076,1040,1646,1382.0,2413.0,28.02108678021087,29.878652798415057,1031.0,3144,606,32.79262086513995
2009,Services,160,263,36,49,40.0,61.0,25.0,23.193916349809886,21.0,103,13,20.388349514563107
2010,Accountancy,2159,3645,553,933,689.0,1169.0,31.91292264937471,32.07133058984911,480.0,1486,380,32.30148048452221
2010,"Architecture, Building & Real Estate",1117,1786,173,263,280.0,426.0,25.06714413607878,23.852183650615903,146.0,669,90,21.823617339312406
2010,Business & Administration,3287,5763,856,1514,901.0,1607.0,27.41101308183754,27.884782231476663,706.0,2476,658,28.513731825525042
2010,Dentistry,108,184,25,41,31.0,48.0,28.703703703703702,26.08695652173913,17.0,76,16,22.36842105263158
2010,Education,0,0,0,0,0.0,0.0,,,0.0,0,0,
2010,Engineering Sciences,4498,15387,946,3786,1144.0,4080.0,25.433526011560694,26.515890037044258,2936.0,10889,2840,26.962990173569658
2010,Fine & Applied Arts,607,1080,121,205,186.0,345.0,30.642504118616145,31.944444444444443,159.0,473,84,33.61522198731501
2010,Health Sciences,783,1064,196,235,189.0,276.0,24.137931034482758,25.93984962406015,87.0,281,39,30.96085409252669
2010,Humanities & Social Sciences,7424,10743,1645,2381,1807.0,2691.0,24.33997844827586,25.04886903099693,884.0,3319,736,26.634528472431455
2010,Information Technology,1068,3355,162,631,276.0,939.0,25.84269662921348,27.98807749627422,663.0,2287,469,28.989943156974203
2010,Law,783,1423,89,227,175.0,350.0,22.349936143039592,24.595924104005622,175.0,640,138,27.34375
2010,Mass Communication,490,675,147,177,122.0,164.0,24.897959183673468,24.296296296296298,42.0,185,30,22.7027027027027
2010,Medicine,620,1305,94,228,121.0,260.0,19.516129032258064,19.92337164750958,139.0,685,134,20.291970802919707
2010,"Natural, Physical & Mathematical Sciences",4949,8361,1172,1766,1297.0,2232.0,26.20731460901192,26.695371367061355,935.0,3412,594,27.403282532239157
2010,Services,363,524,35,64,236.0,322.0,65.0137741046832,61.45038167938932,86.0,161,29,53.41614906832298
2011,Accountancy,2244,3871,507,839,618.0,1100.0,27.540106951871657,28.416429863084474,482.0,1627,332,29.625076828518747
2011,"Architecture, Building & Real Estate",1163,1857,247,368,315.0,475.0,27.08512467755804,25.578890683898763,160.0,694,121,23.054755043227665
2011,Business & Administration,3237,5780,944,1577,910.0,1637.0,28.11244979919679,28.32179930795848,727.0,2543,633,28.588281557215886
2011,Dentistry,111,190,26,42,29.0,48.0,26.126126126126128,25.263157894736842,19.0,79,16,24.050632911392405
2011,Education,1301,1752,303,406,293.0,397.0,22.521137586471944,22.659817351598175,104.0,451,103,23.059866962305986
2011,Engineering Sciences,4598,15624,1119,3891,1241.0,4248.0,26.989995650282733,27.1889400921659,3007.0,11026,2772,27.27190277525848
2011,Fine & Applied Arts,640,1179,132,216,180.0,347.0,28.125,29.431721798134014,167.0,539,84,30.98330241187384
2011,Health Sciences,820,1139,213,255,264.0,347.0,32.19512195121951,30.465320456540827,83.0,319,42,26.018808777429467
2011,Humanities & Social Sciences,6447,9689,1772,2480,1660.0,2453.0,25.74841011323096,25.317370213644338,793.0,3242,708,24.46020974706971
2011,Information Technology,1178,3643,195,583,364.0,1057.0,30.899830220713074,29.01454844908043,693.0,2465,388,28.113590263691684
2011,Law,742,1448,208,329,172.0,364.0,23.18059299191375,25.138121546961326,192.0,706,121,27.195467422096318
2011,Mass Communication,490,673,133,174,135.0,174.0,27.551020408163264,25.85438335809807,39.0,183,41,21.311475409836067
2011,Medicine,647,1328,119,255,148.0,280.0,22.874806800618238,21.08433734939759,132.0,681,136,19.383259911894275
2011,"Natural, Physical & Mathematical Sciences",4482,7822,1217,1836,1335.0,2252.0,29.785809906291835,28.790590641779595,917.0,3340,619,27.45508982035928
2011,Services,575,827,50,74,269.0,387.0,46.78260869565217,46.7956469165659,118.0,252,24,46.82539682539682
2012,Accountancy,2316,4001,589,1036,682.0,1213.0,29.447322970639032,30.31742064483879,531.0,1685,447,31.513353115727003
2012,"Architecture, Building & Real Estate",1119,1829,241,396,216.0,395.0,19.302949061662197,21.596500820120283,179.0,710,155,25.211267605633804
2012,Business & Administration,3368,6073,825,1397,989.0,1732.0,29.3646080760095,28.51967726000329,743.0,2705,572,27.46765249537893
2012,Dentistry,120,201,21,42,30.0,53.0,25.0,26.3681592039801,23.0,81,21,28.395061728395063
2012,Education,1130,1538,503,614,344.0,417.0,30.442477876106196,27.113133940182056,73.0,408,111,17.892156862745097
2012,Engineering Sciences,4785,16185,1119,3727,1344.0,4436.0,28.087774294670847,27.40809391411801,3092.0,11400,2608,27.12280701754386
2012,Fine & Applied Arts,761,1347,149,257,270.0,436.0,35.4796320630749,32.36822568671121,166.0,586,108,28.32764505119454
2012,Health Sciences,948,1293,218,279,359.0,447.0,37.869198312236286,34.5707656612529,88.0,345,61,25.507246376811594
2012,Humanities & Social Sciences,6760,10087,1494,2231,1758.0,2596.0,26.005917159763314,25.736095965103598,838.0,3327,737,25.187856928163512
2012,Information Technology,1236,3853,280,764,354.0,1028.0,28.640776699029125,26.68050869452375,674.0,2617,484,25.754680932365304
2012,Law,717,1474,207,347,191.0,374.0,26.638772663877266,25.37313432835821,183.0,757,140,24.17437252311757
2012,Mass Communication,494,678,133,170,143.0,180.0,28.94736842105263,26.548672566371682,37.0,184,37,20.108695652173914
2012,Medicine,679,1374,123,252,157.0,300.0,23.12223858615611,21.83406113537118,143.0,695,129,20.575539568345324
2012,"Natural, Physical & Mathematical Sciences",4625,7883,1074,1911,1382.0,2244.0,29.88108108108108,28.466319928961056,862.0,3258,837,26.45794966236955
2012,Services,702,1047,135,189,221.0,348.0,31.48148148148148,33.2378223495702,127.0,345,54,36.81159420289855
2013,Accountancy,2274,4042,688,1087,679.0,1185.0,29.859278803869834,29.317169717961406,506.0,1768,399,28.619909502262445
2013,"Architecture, Building & Real Estate",1123,1883,258,401,222.0,404.0,19.768477292965272,21.455124800849706,182.0,760,143,23.94736842105263
2013,Business & Administration,3406,6188,897,1590,977.0,1780.0,28.684674104521434,28.76535229476406,803.0,2782,693,28.86412652767793
2013,Dentistry,124,207,27,48,31.0,54.0,25.0,26.08695652173913,23.0,83,21,27.710843373493976
2013,Education,975,1282,402,565,246.0,314.0,25.23076923076923,24.492979719188767,68.0,307,163,22.149837133550488
2013,Engineering Sciences,4893,16187,1242,4312,1482.0,4733.0,30.288166768853465,29.23951318959659,3251.0,11294,3070,28.785195679121657
2013,Fine & Applied Arts,864,1492,152,290,271.0,471.0,31.36574074074074,31.568364611260055,200.0,628,138,31.84713375796178
2013,Health Sciences,1054,1441,296,391,404.0,541.0,38.33017077798861,37.543372657876475,137.0,387,95,35.400516795865634
2013,Humanities & Social Sciences,7095,10645,1766,2584,2132.0,3186.0,30.049330514446794,29.929544387036167,1054.0,3550,818,29.690140845070424
2013,Information Technology,1321,4058,251,824,351.0,1086.0,26.57077971233914,26.761951700344998,735.0,2737,573,26.854219948849106
2013,Law,736,1491,179,368,208.0,403.0,28.26086956521739,27.028839704896043,195.0,755,189,25.827814569536425
2013,Mass Communication,529,702,100,162,135.0,186.0,25.519848771266542,26.495726495726494,51.0,173,62,29.479768786127167
2013,Medicine,744,1469,124,258,189.0,354.0,25.403225806451612,24.098025867937373,165.0,725,134,22.75862068965517
2013,"Natural, Physical & Mathematical Sciences",4715,7855,1257,2127,1430.0,2237.0,30.328738069989395,28.47867600254615,807.0,3140,870,25.70063694267516
2013,Services,551,922,345,481,178.0,317.0,32.3049001814882,34.38177874186551,139.0,371,136,37.46630727762803
2014,Accountancy,2456,4368,649,1122,860.0,1515.0,35.01628664495114,34.684065934065934,655.0,1912,473,34.25732217573222
2014,"Architecture, Building & Real Estate",1213,1990,258,404,314.0,470.0,25.886232481450946,23.618090452261306,156.0,777,146,20.077220077220076
2014,Business & Administration,3597,6577,846,1477,1065.0,1902.0,29.608006672226857,28.918960012163602,837.0,2980,631,28.08724832214765
2014,Dentistry,132,216,30,45,38.0,54.0,28.78787878787879,25.0,16.0,84,15,19.047619047619047
2014,Education,813,1065,388,508,233.0,301.0,28.65928659286593,28.262910798122064,68.0,252,120,26.984126984126984
2014,Engineering Sciences,5050,16606,1174,4221,1441.0,4938.0,28.534653465346533,29.736239913284354,3497.0,11556,3047,30.261336102457598
2014,Fine & Applied Arts,937,1578,229,394,304.0,491.0,32.44397011739594,31.11533586818758,187.0,641,165,29.173166926677066
2014,Health Sciences,1076,1498,309,433,379.0,544.0,35.22304832713755,36.315086782376504,165.0,422,124,39.09952606635071
2014,Humanities & Social Sciences,7535,11291,1619,2422,2107.0,3129.0,27.9628400796284,27.712337259764414,1022.0,3756,803,27.209797657082003
2014,Information Technology,1343,4152,289,997,343.0,1166.0,25.53983618763961,28.082851637764932,823.0,2809,708,29.29868280526878
2014,Law,715,1514,176,356,170.0,397.0,23.776223776223777,26.221928665786,227.0,799,180,28.410513141426783
2014,Mass Communication,555,729,114,158,139.0,185.0,25.045045045045047,25.377229080932786,46.0,174,44,26.436781609195403
2014,Medicine,801,1585,127,261,182.0,379.0,22.72159800249688,23.91167192429022,197.0,784,134,25.127551020408163
2014,"Natural, Physical & Mathematical Sciences",4922,8145,1103,1889,1357.0,2276.0,27.570093457943926,27.94352363413137,919.0,3223,786,28.51380701210053
2014,Services,393,679,219,354,69.0,123.0,17.557251908396946,18.114874815905743,54.0,286,135,18.88111888111888
2015,Accountancy,2684,4723,556,1036,830.0,1470.0,30.923994038748138,31.124285411814526,640.0,2039,480,31.38793526238352
2015,"Architecture, Building & Real Estate",1189,1973,351,539,262.0,419.0,22.035323801513876,21.236695387734414,157.0,784,188,20.025510204081634
2015,Business & Administration,4027,7138,848,1619,1272.0,2120.0,31.586789173081698,29.700196133370692,848.0,3111,771,27.25811636129862
2015,Dentistry,134,219,32,51,34.0,54.0,25.37313432835821,24.65753424657534,20.0,85,19,23.529411764705884
2015,Education,751,955,305,401,247.0,294.0,32.88948069241012,30.785340314136125,47.0,204,96,23.03921568627451
2015,Engineering Sciences,4970,16677,1296,4374,1429.0,4934.0,28.75251509054326,29.585656892726508,3505.0,11707,3078,29.93935252413086
2015,Fine & Applied Arts,934,1599,233,420,244.0,466.0,26.124197002141326,29.14321450906817,222.0,665,187,33.38345864661654
2015,Health Sciences,1126,1567,353,481,417.0,569.0,37.03374777975133,36.311423101467774,152.0,441,128,34.467120181405896
2015,Humanities & Social Sciences,8054,11915,1450,2193,2158.0,3191.0,26.79413955798361,26.78136802349979,1033.0,3861,743,26.754726754726754
2015,Information Technology,1492,4541,377,1066,389.0,1247.0,26.072386058981234,27.46091169345959,858.0,3049,689,28.140373893079698
2015,Law,706,1550,168,355,171.0,405.0,24.22096317280453,26.129032258064516,234.0,844,187,27.725118483412324
2015,Mass Communication,602,776,130,172,181.0,221.0,30.06644518272425,28.47938144329897,40.0,174,42,22.988505747126435
2015,Medicine,859,1719,115,252,176.0,390.0,20.488940628637952,22.68760907504363,214.0,860,137,24.88372093023256
2015,"Natural, Physical & Mathematical Sciences",4989,8226,1145,1935,1288.0,2147.0,25.816796953297253,26.10017019207391,859.0,3237,790,26.53691689836268
2015,Services,373,725,188,342,94.0,199.0,25.201072386058982,27.448275862068964,105.0,352,154,29.829545454545453
2016,Accountancy,2909,5090,664,1103,912.0,1521.0,31.350979718116193,29.88212180746562,609.0,2181,439,27.92297111416781
2016,"Architecture, Building & Real Estate",1205,1980,274,459,252.0,419.0,20.91286307053942,21.161616161616163,167.0,775,185,21.548387096774192
2016,Business & Administration,4230,7514,969,1720,1237.0,2196.0,29.243498817966902,29.225445834442375,959.0,3284,751,29.202192448233863
2016,Dentistry,145,220,28,53,39.0,54.0,26.896551724137932,24.545454545454547,15.0,75,25,20.0
2016,Education,577,743,327,406,172.0,217.0,29.80935875216638,29.205921938088828,45.0,166,79,27.10843373493976
2016,Engineering Sciences,4859,16975,1267,4283,1333.0,4997.0,27.43362831858407,29.43740795287187,3664.0,12116,3016,30.241003631561572
2016,Fine & Applied Arts,958,1628,259,432,297.0,458.0,31.002087682672233,28.132678132678134,161.0,670,173,24.029850746268657
2016,Health Sciences,1335,1860,368,480,593.0,798.0,44.41947565543071,42.903225806451616,205.0,525,112,39.04761904761905
2016,Humanities & Social Sciences,8449,12495,1760,2563,2205.0,3219.0,26.097763048881525,25.762304921968788,1014.0,4046,803,25.061789421651014
2016,Information Technology,1499,4810,381,1051,398.0,1379.0,26.551034022681787,28.66943866943867,981.0,3311,670,29.62851102385986
2016,Law,740,1593,173,351,210.0,399.0,28.37837837837838,25.04708097928437,189.0,853,178,22.157092614302464
2016,Mass Communication,596,774,153,188,148.0,190.0,24.83221476510067,24.54780361757106,42.0,178,35,23.59550561797753
2016,Medicine,912,1845,147,278,204.0,410.0,22.36842105263158,22.22222222222222,206.0,933,131,22.079314040728832
2016,"Natural, Physical & Mathematical Sciences",4967,8267,1195,1950,1240.0,2094.0,24.964767465270786,25.329623805491714,854.0,3300,755,25.87878787878788
2016,Services,382,737,95,179,110.0,201.0,28.79581151832461,27.272727272727273,91.0,355,84,25.633802816901408
2017,Accountancy,2963,5226,725,1278,834.0,1508.0,28.14714816064799,28.855721393034827,674.0,2263,553,29.783473265576667
2017,"Architecture, Building & Real Estate",1222,2015,238,433,219.0,410.0,17.921440261865794,20.34739454094293,191.0,793,195,24.08575031525851
2017,Business & Administration,4665,8165,936,1691,1405.0,2393.0,30.117899249732048,29.308022045315372,988.0,3500,755,28.228571428571428
2017,Dentistry,141,217,33,56,30.0,54.0,21.27659574468085,24.88479262672811,24.0,76,23,31.57894736842105
2017,Education,502,627,206,260,150.0,170.0,29.8804780876494,27.11323763955343,20.0,125,54,16.0
2017,Engineering Sciences,4770,17169,1343,4475,1474.0,5255.0,30.90146750524109,30.6074902440445,3781.0,12399,3132,30.494394709250745
2017,Fine & Applied Arts,957,1629,257,424,276.0,464.0,28.84012539184953,28.483732351135664,188.0,672,167,27.976190476190474
2017,Health Sciences,1611,2244,410,552,703.0,962.0,43.637492240844196,42.8698752228164,259.0,633,142,40.91627172195893
2017,Humanities & Social Sciences,8475,12660,1963,2908,2068.0,3173.0,24.40117994100295,25.063191153238545,1105.0,4185,945,26.403823178016726
2017,Information Technology,1599,5360,330,977,448.0,1579.0,28.017510944340213,29.458955223880597,1131.0,3761,647,30.071789417708057
2017,Law,741,1588,188,375,201.0,391.0,27.125506072874494,24.622166246851386,190.0,847,187,22.43211334120425
2017,Mass Communication,599,781,128,176,135.0,189.0,22.537562604340568,24.199743918053777,54.0,182,48,29.67032967032967
2017,Medicine,946,1962,156,301,194.0,423.0,20.507399577167018,21.559633027522935,229.0,1016,145,22.53937007874016
2017,"Natural, Physical & Mathematical Sciences",4544,7826,1308,2038,815.0,1495.0,17.93573943661972,19.102990033222593,680.0,3282,730,20.719073735527118
2017,Services,377,712,117,216,121.0,202.0,32.09549071618037,28.370786516853933,81.0,335,99,24.17910447761194
2018,Accountancy,2898,5219,720,1299,731.0,1421.0,25.224292615596962,27.22743820655298,690.0,2321,579,29.72856527358897
2018,"Architecture, Building & Real Estate",1190,1993,343,517,280.0,458.0,23.529411764705884,22.980431510286,178.0,803,174,22.166874221668742
2018,Business & Administration,5277,9018,1047,1884,1701.0,2785.0,32.23422399090392,30.8826790862719,1084.0,3741,837,28.976209569633788
2018,Dentistry,135,224,39,53,33.0,60.0,24.444444444444443,26.785714285714285,27.0,89,14,30.337078651685392
2018,Education,449,549,226,283,185.0,220.0,41.202672605790646,40.07285974499089,35.0,100,57,35.0
2018,Engineering Sciences,4909,17656,1226,4380,1484.0,5213.0,30.23018944795274,29.525373810602627,3729.0,12747,3154,29.253942104024475
2018,Fine & Applied Arts,945,1607,275,455,247.0,410.0,26.137566137566136,25.51337896701929,163.0,662,180,24.622356495468278
2018,Health Sciences,1927,2678,385,535,728.0,1001.0,37.77893098079917,37.37864077669903,273.0,751,150,36.35153129161119
2018,Humanities & Social Sciences,8753,12973,1975,2920,2327.0,3368.0,26.58517079858334,25.961612579973792,1041.0,4220,945,24.66824644549763
2018,Information Technology,1905,6143,373,1244,685.0,2039.0,35.958005249343834,33.19225134299202,1354.0,4238,871,31.949032562529496
2018,Law,818,1708,165,403,226.0,480.0,27.628361858190708,28.10304449648712,254.0,890,238,28.53932584269663
2018,Mass Communication,600,778,142,188,146.0,188.0,24.333333333333332,24.164524421593832,42.0,178,46,23.59550561797753
2018,Medicine,966,2045,189,355,208.0,437.0,21.532091097308488,21.369193154034228,229.0,1079,166,21.223354958294717
2018,"Natural, Physical & Mathematical Sciences",4136,7361,1271,2110,916.0,1739.0,22.147001934235977,23.62450753973645,823.0,3225,839,25.51937984496124
2018,Services,385,738,99,197,104.0,222.0,27.01298701298701,30.08130081300813,118.0,353,98,33.42776203966006
2019,Accountancy,2801,5128,830,1418,780.0,1433.0,27.84719742948947,27.94461778471139,653.0,2327,588,28.061882251826386
2019,"Architecture, Building & Real Estate",1173,2020,310,492,288.0,492.0,24.55242966751918,24.356435643564357,204.0,847,182,24.08500590318772
2019,Business & Administration,5894,10028,1178,2025,1859.0,3110.0,31.54054971157109,31.013163143199044,1251.0,4134,847,30.261248185776488
2019,Dentistry,141,232,33,52,39.0,60.0,27.659574468085108,25.862068965517242,21.0,91,19,23.076923076923077
2019,Education,500,606,102,135,156.0,190.0,31.2,31.353135313531354,34.0,106,33,32.075471698113205
2019,Engineering Sciences,5106,18132,1207,4439,1473.0,5101.0,28.848413631022325,28.13258327818222,3628.0,13026,3232,27.85198833103025
2019,Fine & Applied Arts,940,1577,242,423,249.0,423.0,26.48936170212766,26.82308180088776,174.0,637,181,27.315541601255887
2019,Health Sciences,2255,3107,430,584,784.0,1045.0,34.76718403547672,33.63373028644995,261.0,852,154,30.633802816901408
2019,Humanities & Social Sciences,8965,13192,2052,3030,2299.0,3311.0,25.644171779141104,25.098544572468164,1012.0,4227,978,23.941329548142892
2019,Information Technology,2374,7386,383,1186,874.0,2520.0,36.815501263689974,34.11860276198213,1646.0,5012,803,32.84118116520351
2019,Law,862,1774,155,372,215.0,465.0,24.94199535962877,26.211950394588502,250.0,912,217,27.412280701754387
2019,Mass Communication,564,725,175,216,144.0,168.0,25.53191489361702,23.17241379310345,24.0,161,41,14.906832298136646
2019,Medicine,978,2095,181,375,194.0,430.0,19.83640081799591,20.525059665871122,236.0,1117,194,21.128021486123544
2019,"Natural, Physical & Mathematical Sciences",3904,7039,1196,1987,1023.0,1747.0,26.203893442622952,24.8188663162381,724.0,3135,791,23.094098883572567
2019,Services,393,756,82,177,102.0,218.0,25.954198473282442,28.835978835978835,116.0,363,95,31.955922865013775
2020,Accountancy,2759,4982,812,1411,812.0,1368.0,29.43095324392896,27.45885186672019,556.0,2223,599,25.011246063877643
2020,"Architecture, Building & Real Estate",1183,2023,258,426,304.0,483.0,25.69737954353339,23.875432525951556,179.0,840,168,21.30952380952381
2020,Business & Administration,6684,11275,1209,2105,2039.0,3378.0,30.505685218432077,29.96008869179601,1339.0,4591,896,29.16575909387933
2020,Dentistry,165,253,35,51,59.0,72.0,35.75757575757576,28.458498023715414,13.0,88,16,14.772727272727273
2020,Education,577,690,115,145,153.0,184.0,26.51646447140381,26.666666666666668,31.0,113,30,27.43362831858407
2020,Engineering Sciences,5149,18050,1246,4621,1503.0,5225.0,29.190134006603223,28.94736842105263,3722.0,12901,3375,28.850476707231998
2020,Fine & Applied Arts,911,1517,272,429,251.0,384.0,27.552140504939626,25.313117996044824,133.0,606,157,21.94719471947195
2020,Health Sciences,2455,3347,522,724,761.0,1018.0,30.9979633401222,30.415297281147296,257.0,892,202,28.81165919282511
2020,Humanities & Social Sciences,8783,12892,2125,3147,2001.0,2930.0,22.782648297848116,22.727272727272727,929.0,4109,1022,22.60890727670966
2020,Information Technology,2797,8811,397,1367,846.0,2863.0,30.24669288523418,32.49347406650777,2017.0,6014,970,33.53841037578982
2020,Law,907,1823,204,394,259.0,463.0,28.555678059536934,25.3976961053209,204.0,916,190,22.270742358078603
2020,Mass Communication,566,714,142,181,142.0,170.0,25.08833922261484,23.80952380952381,28.0,148,39,18.91891891891892
2020,Medicine,1020,2178,178,386,224.0,477.0,21.96078431372549,21.90082644628099,253.0,1158,208,21.848013816925732
2020,Natural & Mathematical Sciences,3624,6713,1127,1928,891.0,1679.0,24.58609271523179,25.01117235215254,788.0,3089,801,25.50987374554872
2020,Services,412,814,112,219,139.0,282.0,33.737864077669904,34.643734643734646,143.0,402,107,35.57213930348259
2021,Accountancy,2726,4859,732,1355,757.0,1356.0,27.76962582538518,27.906976744186046,599.0,2133,623,28.082512892639475
2021,"Architecture, Building & Real Estate",1171,1964,247,458,255.0,430.0,21.776259607173355,21.894093686354378,175.0,793,211,22.06809583858764
2021,Business & Administration,7274,12228,1357,2378,2046.0,3483.0,28.127577673907066,28.483807654563297,1437.0,4954,1021,29.006863140896247
2021,Dentistry,199,278,33,58,65.0,81.0,32.663316582914575,29.136690647482013,16.0,79,25,20.253164556962027
2021,Education,561,695,160,184,152.0,196.0,27.094474153297682,28.201438848920862,44.0,134,24,32.83582089552239
2021,Engineering Sciences,5254,18366,1202,4534,1397.0,5116.0,26.58926532165969,27.85582053795056,3719.0,13112,3332,28.36333129957291
2021,Fine & Applied Arts,870,1414,255,429,251.0,376.0,28.850574712643677,26.59123055162659,125.0,544,174,22.977941176470587
2021,Health Sciences,2642,3606,576,777,817.0,1093.0,30.923542770628313,30.31059345535219,276.0,964,201,28.630705394190873
2021,Humanities & Social Sciences,8506,12506,1984,2998,1789.0,2727.0,21.032212555842936,21.80553334399488,938.0,4000,1014,23.45
2021,Information Technology,3027,10219,426,1418,705.0,2952.0,23.290386521308225,28.887366669928564,2247.0,7192,992,31.24304783092325
2021,Law,909,1875,216,415,230.0,485.0,25.302530253025303,25.866666666666667,255.0,966,199,26.39751552795031
2021,Mass Communication,574,708,136,188,140.0,176.0,24.390243902439025,24.858757062146893,36.0,134,52,26.865671641791046
2021,Medicine,1052,2251,196,397,227.0,471.0,21.577946768060837,20.9240337627721,244.0,1199,201,20.350291909924938
2021,Natural & Mathematical Sciences,3912,7071,874,1620,1193.0,2050.0,30.495910020449898,28.99165605996323,857.0,3159,746,27.12883823994935
2021,Services,451,905,131,229,163.0,315.0,36.14190687361419,34.806629834254146,152.0,454,98,33.480176211453745
2022,Accountancy,2740,4744,641,1200,662.0,1172.0,24.16058394160584,24.70489038785835,510.0,2004,559,25.449101796407184
2022,"Architecture, Building & Real Estate",721,1953,295,495,167.0,338.0,23.162274618585297,17.306707629288276,171.0,1232,200,13.87987012987013
2022,Business & Administration,7466,12730,1624,2738,1948.0,3518.0,26.091615322796677,27.63550667714061,1570.0,5264,1114,29.825227963525837
2022,Dentistry,191,278,34,60,54.0,80.0,28.272251308900522,28.776978417266186,26.0,87,26,29.885057471264368
2022,Education,490,616,161,195,141.0,180.0,28.775510204081634,29.22077922077922,39.0,126,34,30.952380952380953
2022,Engineering Sciences,5352,17985,1375,4842,1295.0,4897.0,24.196562032884902,27.22824576035585,3602.0,12633,3467,28.512625662946252
2022,Fine & Applied Arts,877,1452,187,321,252.0,373.0,28.734321550741164,25.68870523415978,121.0,575,134,21.043478260869566
2022,Health Sciences,2638,3763,621,851,812.0,1075.0,30.78089461713419,28.567632208344406,263.0,1125,230,23.377777777777776
2022,Humanities & Social Sciences,7986,12322,2207,3197,1578.0,,19.759579263711494,,,4336,990,
2022,Information Technology,3195,10896,557,1786,764.0,2975.0,23.912363067292645,27.30359765051395,2211.0,7701,1229,28.710557070510323
2022,Law,1026,1899,203,434,269.0,491.0,26.21832358674464,25.855713533438653,222.0,873,231,25.42955326460481
2022,Mass Communication,558,674,143,187,132.0,159.0,23.655913978494624,23.590504451038576,27.0,116,44,23.275862068965516
2022,Medicine,1212,2301,192,421,246.0,461.0,20.297029702970296,20.03476749239461,215.0,1089,229,19.742883379247015
2022,Natural & Mathematical Sciences,3970,6964,855,1629,1060.0,1892.0,26.700251889168765,27.168294083859852,832.0,2994,774,27.788911155644623
2022,Services,538,1031,78,171,174.0,314.0,32.342007434944236,30.455868089233753,140.0,493,93,28.397565922920894
2023,Accountancy,2502,4430,753,1286,632.0,1131.0,25.259792166266987,25.530474040632054,499.0,1928,533,25.88174273858921
2023,"Architecture, Building & Real Estate",920,1610,283,465,185.0,298.0,20.108695652173914,18.509316770186334,113.0,690,182,16.3768115942029
2023,Business & Administration,7272,12391,1852,3037,1797.0,3033.0,24.71122112211221,24.47744330562505,1236.0,5119,1185,24.145340886891972
2023,Dentistry,230,319,38,59,49.0,80.0,21.304347826086957,25.078369905956112,31.0,89,21,34.831460674157306
2023,Education,525,644,133,166,168.0,208.0,32.0,32.298136645962735,40.0,119,33,33.61344537815126
2023,Engineering Sciences,5519,18927,1208,4257,1649.0,5396.0,29.878601195868818,28.509536640777725,3747.0,13408,3049,27.946002386634845
2023,Fine & Applied Arts,960,1459,221,370,260.0,391.0,27.083333333333332,26.799177518848527,131.0,499,149,26.25250501002004
2023,Health Sciences,2904,3911,718,948,870.0,1149.0,29.958677685950413,29.378675530554844,279.0,1007,230,27.706057596822244
2023,Humanities & Social Sciences,9441,14884,2608,3918,2218.0,3496.0,23.493274017582884,23.48830959419511,1278.0,5443,1310,23.479698695572296
2023,Information Technology,3559,12918,845,2492,1034.0,3701.0,29.053104804720427,28.649945812045207,2667.0,9359,1647,28.49663425579656
2023,Law,1041,1954,209,447,299.0,520.0,28.7223823246878,26.61207778915046,221.0,913,238,24.20591456736035
2023,Mass Communication,534,656,144,169,124.0,155.0,23.220973782771537,23.628048780487806,31.0,122,25,25.40983606557377
2023,Medicine,1110,2270,210,441,216.0,431.0,19.45945945945946,18.986784140969164,215.0,1160,231,18.53448275862069
2023,Natural & Mathematical Sciences,1932,3419,539,875,559.0,949.0,28.93374741200828,27.75665399239544,390.0,1487,336,26.227303295225287
2023,Services,610,1152,109,232,193.0,370.0,31.639344262295083,32.11805555555556,177.0,542,123,32.656826568265686
